25 23
9 9
4 4 4 4 4 4 4 4 4 9 7 7 7 7 7 7 7 7 7 7 7 7 10 4 4
4 4 4 4 4 4 4 4 9 8 17 17 17 17 17 17 17 17 17 17 17 17 6 10 4
4 4 4 4 4 4 4 9 8 17 17 17 17 17 17 17 17 17 17 17 17 17 17 3 4
4 4 4 4 4 4 4 5 17 17 17 17 17 17 17 17 17 17 17 17 17 17 17 6 10
4 4 4 4 4 4 9 8 17 17 17 17 17 17 17 17 17 17 17 17 17 17 17 17 3
4 4 4 4 4 4 5 17 17 17 17 17 17 17 17 17 17 17 17 17 17 17 17 17 3
4 4 4 4 4 9 8 17 17 17 17 17 17 17 17 17 17 17 17 17 17 17 17 17 3
4 4 4 4 4 5 17 17 17 17 17 17 17 17 17 17 17 17 17 17 19 17 17 17 3
4 4 4 4 9 8 17 13 18 18 18 18 14 17 17 17 17 17 17 17 19 17 17 17 3
4 4 4 4 5 17 17 19 17 17 17 17 19 17 17 17 17 17 17 17 19 17 17 17 3
4 4 4 4 11 1 1 19 1 2 17 17 19 17 17 17 17 17 17 17 19 17 17 17 3
4 4 4 9 7 7 7 19 10 5 17 17 19 17 17 17 17 17 17 17 19 17 17 17 3
4 4 4 5 17 17 17 19 3 11 1 1 19 1 1 1 2 17 17 17 19 17 17 17 3
4 4 9 8 17 13 18 16 6 7 7 7 19 7 7 10 5 17 17 17 19 17 17 17 3
4 4 5 17 17 19 17 17 17 17 17 17 19 17 17 3 11 1 1 1 19 1 1 1 12
4 4 5 17 17 19 17 17 17 17 17 17 19 17 17 3 9 7 7 7 19 7 7 7 10
4 4 11 1 1 19 1 1 1 1 2 17 19 17 17 3 5 17 17 17 19 17 17 17 3
4 9 7 7 7 19 7 7 7 10 11 1 19 1 1 12 5 17 17 17 19 17 17 17 3
4 5 17 17 17 19 17 17 17 6 7 7 19 7 7 7 8 17 17 17 19 17 17 17 3
9 8 17 17 17 17 17 17 17 17 17 17 19 17 17 17 17 17 17 17 17 17 17 17 3
5 17 17 17 17 17 17 18 18 18 18 18 18 18 18 18 18 18 18 18 18 17 17 17 3
5 17 17 17 17 17 17 17 17 17 17 17 17 17 17 17 17 17 17 17 17 17 17 17 3
11 1 1 1 1 1 1 1 1 1 1 1 1 1 1 1 1 1 1 1 1 1 1 1 12
