46 29
6 13
4 4 4 4 4 4 4 4 4 4 4 4 4 4 4 4 9 7 7 7 7 7 10 9 7 7 7 7 7 7 10 4 4 4 4 4 4 4 4 4 4 4 4 4 4 4
4 4 4 4 4 4 4 4 4 4 4 4 4 4 4 9 8 17 17 17 17 17 3 5 17 17 17 17 17 17 6 7 7 7 10 4 4 4 4 4 4 4 4 4 4 4
4 4 4 4 4 4 4 9 7 10 9 7 10 4 9 8 17 17 17 17 17 17 3 5 17 17 17 17 17 17 17 17 17 17 6 7 10 4 4 4 4 4 4 4 4 4
4 4 4 4 4 9 7 8 17 3 5 17 6 10 5 17 17 17 17 17 17 17 3 5 17 17 17 17 17 17 17 17 17 17 17 17 6 10 4 4 4 4 4 4 4 4
4 4 4 4 9 8 17 17 17 3 5 17 17 6 8 17 17 17 17 17 17 17 3 5 17 17 17 17 17 17 17 17 17 17 17 17 17 3 4 4 4 4 4 4 4 4
4 4 4 9 8 17 17 17 17 3 5 17 17 17 17 17 17 17 17 17 17 17 3 5 17 17 17 17 17 17 17 17 17 17 17 17 17 6 10 4 4 4 4 4 4 4
4 4 4 5 17 17 17 17 17 3 5 17 17 17 17 17 17 17 17 17 17 17 3 11 1 1 2 17 17 17 17 17 17 17 17 17 17 17 6 7 10 4 4 4 4 4
4 4 4 5 17 17 17 17 17 3 5 17 17 17 17 17 17 17 17 17 17 17 6 7 7 10 5 17 17 17 17 17 17 17 17 17 17 17 17 17 6 10 4 4 4 4
4 9 7 8 17 17 17 17 17 3 5 17 17 17 17 17 13 18 18 18 18 18 18 18 18 18 18 18 18 18 18 14 17 17 17 17 17 17 17 17 17 6 10 4 4 4
4 5 17 17 17 17 17 19 17 3 5 17 17 17 17 17 19 17 17 17 17 17 17 17 17 3 5 17 17 17 17 19 17 17 17 17 17 17 17 17 17 17 3 4 4 4
4 5 17 17 17 17 17 19 17 3 5 17 17 17 17 17 19 17 17 17 17 17 17 17 17 3 5 17 17 17 17 19 17 17 17 17 17 0 2 17 17 17 3 4 4 4
4 5 17 17 17 17 17 19 17 3 11 1 1 1 2 17 19 17 17 17 17 17 17 17 17 3 11 1 1 2 17 19 17 17 17 17 17 6 8 17 17 17 3 4 4 4
4 5 17 17 17 17 17 19 17 6 7 7 7 10 5 17 19 17 17 17 17 17 17 17 17 6 7 7 10 5 17 19 17 17 17 17 17 17 17 17 17 0 12 4 4 4
4 5 17 17 17 17 17 19 17 17 17 17 17 3 5 17 19 17 17 17 17 17 17 17 17 17 17 17 3 5 17 19 17 17 17 17 17 17 17 17 0 12 4 4 4 4
4 5 17 17 17 17 17 19 17 17 17 17 17 3 5 17 19 17 17 17 17 17 17 17 17 17 0 1 12 5 17 19 17 17 17 17 17 17 17 0 12 4 4 4 4 4
4 11 2 17 17 17 17 19 17 17 17 17 17 3 11 1 19 1 1 1 2 17 17 17 17 0 12 4 4 11 1 19 1 1 1 1 1 1 1 12 4 4 4 4 4 4
4 4 5 17 17 17 17 19 17 17 17 17 17 6 7 7 19 7 7 10 5 17 17 17 0 12 4 9 7 7 7 19 7 7 7 7 7 7 7 7 10 4 4 4 4 4
4 4 11 2 17 17 17 19 17 17 17 17 17 17 17 17 19 17 17 3 11 1 1 1 12 4 9 8 17 17 17 19 17 17 17 17 17 17 17 17 6 10 4 4 4 4
4 4 4 5 17 17 17 19 17 17 17 17 17 17 17 17 19 17 17 6 7 7 10 4 4 9 8 17 17 17 17 19 17 17 17 17 17 17 17 17 17 6 7 10 4 4
4 4 4 11 2 17 17 19 17 17 17 17 17 17 17 17 19 17 17 17 17 17 3 9 7 8 17 17 17 17 17 19 17 17 17 17 17 17 17 17 17 17 17 6 10 4
4 4 4 4 11 2 17 15 18 18 18 18 18 18 14 17 19 17 17 17 17 17 3 5 17 17 17 17 17 17 17 19 17 17 17 17 17 17 17 17 17 17 17 17 6 10
4 4 4 4 4 11 2 17 17 17 17 17 17 17 19 17 15 18 18 18 18 18 18 18 18 18 18 18 18 18 18 16 17 17 17 17 17 0 2 17 17 17 17 17 17 3
4 4 4 4 4 4 11 1 2 17 17 17 17 17 17 17 17 17 17 17 17 17 3 5 17 17 17 17 17 17 17 17 17 17 17 17 17 6 8 17 17 17 17 17 17 3
4 4 4 4 4 4 4 4 11 1 1 2 17 17 17 17 17 17 17 17 17 17 3 5 17 17 17 17 17 17 17 17 17 17 17 17 17 17 17 17 17 17 17 17 0 12
4 4 4 4 4 4 4 4 4 4 4 5 17 17 17 17 17 17 17 17 17 17 3 5 17 17 17 17 17 17 17 17 17 17 17 0 2 17 17 17 17 17 17 0 12 4
4 4 4 4 4 4 4 4 4 4 4 11 2 17 17 17 17 17 17 17 17 17 3 5 17 17 17 17 17 17 17 17 17 17 17 3 5 17 17 17 17 0 1 12 4 4
4 4 4 4 4 4 4 4 4 4 4 4 11 2 17 17 17 17 17 17 17 17 3 5 17 17 17 17 17 17 17 17 17 17 17 3 11 1 1 1 1 12 4 4 4 4
4 4 4 4 4 4 4 4 4 4 4 4 4 11 1 2 17 17 17 17 17 17 3 5 17 17 17 17 17 17 17 17 17 17 0 12 4 4 4 4 4 4 4 4 4 4
4 4 4 4 4 4 4 4 4 4 4 4 4 4 4 11 1 1 1 1 1 1 12 11 1 1 1 1 1 1 1 1 1 1 12 4 4 4 4 4 4 4 4 4 4 4
